20 15
11111100000000000000
10000100000000000000
10000100000000000000
10000100000000000000
10000100000000000000
11111100000000000000
00000000000000000000
00000000000000000000
00000000000000000000
00000000000000000000
00000000000000000000
00000000000000000000
00000000000000000000
00000000000000000000
00000000000000000000
