20 15
11111111111111111111
10000001000010000001
10000000000000000001
10000000000000000001
10000001000010000001
10000001000010000001
11111111000011111111
10000001000000000001
10000001000000000001
10000000000000000001
10000000000000000001
10000000000000001011
10000001000000001001
10000001000000001001
11111111111111111111
00000000000000000000
00000000000000000000
00000000000000000000
00000000000000000000
00000000000000000000
00000000000000000000
00000000000000000000
00000000000000000000
00000000000000000000
00000000000000000000
00000000000000000000
00000000000000000000
00000000000000000000
00000000000000000000
00000000000000000000
